11111111111111
10E0000C000001
1P000C00000001
10C000E00C0001
11111111111111