11111111111111
10E0000C000001
10000C00000001
10C000E00C00P1
11111111111111